1111111111111
1C010000P00C1
1000C11111001
1P0E11E000001
1111111111111